    NO	                ./assets/NORTH.xpm
SO	./assets/SOUTH.xpm
    EA	        ./assets/EAST.xpm
  WE	./assets/WEST.xpm

F	                                                  137,42,9
          C	25,3,201

        1111111111111111111111111
        1         11            1
        1 11     111            1
        1  1                    1
111111111 11     111            1
1         11     111 111111111111    
1111 111111111 111      1   1    
1111 111111111 111 1 1  1   1    
11      11 1 1 111      1   1    
1               11      1   1    
1               11 1 1  1   1    
11     111 1 1 11111 1111 N 111  
1111 111 111 1 1 1 1111 1   1    
11111111 1111111 111111111111    
